*
622222u222227
3000000000005
3000011100005
l00000000000r
3000011100005
3000000000005
844444d444449
*
622222u222227
3000010000005
3000000010005
l00000000000r
3000010000005
3000000000105
844444d444449
*
622222u222227
3000000000005
3000000001105
l01000000010r
3011000000005
3000000000005
844444d444449
*
622222u222227
3000000000005
3000000000005
l00000000000r
3000000000005
3000000000005
844444d444449
*
622222u222227
3000000000005
3000000000005
300000000000r
3000000000005
3000000000005
8444444444449
*
622222u222227
3000000000005
3000000000005
300000000000r
3000000000005
3000000000005
844444d444449
*
6222222222227
3000000000005
3000000000005
300000000000r
3000000000005
3000000000005
844444d444449
*
622222u222227
3000000000005
3001100000005
l00000000000r
3000000011005
3000000000005
8444444444449
*
6222222222227
3000000000005
3000000000005
l000000000005
3000000000005
3000000000005
844444d444449
*
622222u222227
3100000000005
3000001000005
l000000000105
3000100000105
3000000000005
844444d444449
*
622222u222227
3000000000005
3000000000005
l000000000005
3000000000005
3000000000005
8444444444449
*
6222222222227
3000000000005
3000100000005
l00001000000r
3000001000005
3000000000005
844444d444449