*
1000000000100
0000000000000
0000010000000
0000000000000
0010000100000
0000000000000
1000000000000
