*
6222222222227
3000000000005
3000000000005
3000000000005
3000000000005
3000000000005
8444444444449
*
622222u222227
3000000000005
3000011100005
l00010001000r
3000011100005
3000000000005
844444d444449