*
6222222222227
3000000000005
3000000000005
3000000000005
3000000000005
3000000000005
8444444444449
