*
6222222222227
3000000000005
3000000000005
3000000000005
3000000000005
3000000000005
8444444444449
*
6222222222227
3000000000005
3000011100005
3000100010005
3000011100005
3000000000005
8444444444449